R 1800 500
NO textures/path_to_the_north_texture
SO textures/path_to_the_south_texture
WE textures/path_to_the_west_texture
EA textures/path_to_the_east_texture
S textures/path_to_the_sprite_texture

F 220,220,0
C 225,30,0
0000000000000000000000
111111111111111111111111
10000000000001
100000000000001
10100000000101
10111111111101111111
100000000000000000S1
10000111111111111111
111111
