R 400 400
NO textures/path_to_the_north_texture.xpm
SO textures/path_to_the_south_texture.xpm
WE textures/path_to_the_west_texture.xpm
EA textures/path_to_the_east_texture.xpm
S textures/path_to_the_sprite_texture.xpm

C 135,206,235
F 125,186,111

11111111111111111111111111111111111111111111111111
10000000000000000000000000000000000000000000000001
10000000000000000000000000000000000000000000000001
10000000001111111110000000000000000011111110000001
10000000001000000010000000000000000010000010000001
10000000001000000010000000000000000010000010000001
10000000001000000011111111100011111110000010000001
10000000001000000000000000000000000000000010000001
10000000001111111000000000000000000000000010000001
10000000000000000000000000000000000000000010000001
10000000000000000000000000000000000000000010000001
10000000000000000000000000000000000000000010000001
10000011111111110000000000000000000011111111100001
10000010000000010000000000000000000010000000000001
10000010000000010000000000000000000010000000000001
10000011111111110000000000000000000010000000000001
10000000000000000000000000000000000010000000000001
10000000000000000000000000000000000011111111100001
100000000000000000000000N0000000000000000000000001
10000000000000000000000000000000000000000000000001
11111111111111111111111111111111111111111111111111

