R 1000 1000
NO textures/path_to_the_north_texture.xpm
SO textures/path_to_the_south_texture.xpm
WE textures/path_to_the_west_texture.xpm
EA textures/path_to_the_east_texture.xpm
S textures/path_to_the_sprite_texture.xpm

F 128,128,128
C 0,204,204
0000000000000000000000
111111111111101111111111
1000000000000100000001
11100000001010010000001
00100101010101001000001
11000000000000001111111
100000N0001110000000001
10000000001010000000001
11111111111011111111111
